SSSSSSSSSS
SSSSSSSSSS
SSSSSSSSSS
SSSSSSSSIS
SSSSSSSSSS
SSSSSSSSSS
SSSSSSSSSS
SSSSSSSSSS
SSSSSSSSSS
SSSSSSSSSS

SSSSSSSSSS
SSSSSSSSSS
SSSSSSSSSE
SSSSSSSSIS
SSSSSSSSSS
SSSSSSSSSS
SSSSSSSSSS
SSSSSSSSSS
SSSSSSSSSS
SSSSSSSSSS

SSSSSSSSSS
SSSSSSSSSS
SSSSSSSSSE
SSSSSSSEIS
SSSSSSSSSS
SSSSSSSSSS
SSSSSSSSSS
SSSSSSSSSS
SSSSSSSSSS
SSSSSSSSSS

SSSSSSSSSS
SSSSSSSSSS
SSSSSSSSSE
SSSSSSSEIS
SSSSSSSESS
SSSSSSSSSS
SSSSSSSSSS
SSSSSSSSSS
SSSSSSSSSS
SSSSSSSSSS

SSSSSSSSSS
SSSSSSSSSS
SSSSSSSEEI
SSSSSSSEIS
SSSSSSSESS
SSSSSSSSSS
SSSSSSSSSS
SSSSSSSSSS
SSSSSSSSSS
SSSSSSSSSS

SSSSSSSSSS
SSSSSSSSSS
SSSSSSSEEI
SSSSSSSIIS
SSSSSSSEES
SSSSSSSSSS
SSSSSSSSSS
SSSSSSSSSS
SSSSSSSSSS
SSSSSSSSSS

SSSSSSSSSS
SSSSSSSSSS
SSSSSSSEEI
SSSSSSSIIS
SSSSSSSIES
SSSSSSSSSS
SSSSSSSSSS
SSSSSSSSSS
SSSSSSSSSS
SSSSSSSSSS

SSSSSSSSSS
SSSSSSSSSS
SSSSSSSIII
SSSSSSSIDS
SSSSSSSIEE
SSSSSSSSSS
SSSSSSSSSS
SSSSSSSSSS
SSSSSSSSSS
SSSSSSSSSS

SSSSSSSSSS
SSSSSSSSSS
SSSSSSSIII
SSSSSSSIDS
SSSSSSSIIE
SSSSSSSESS
SSSSSSSSSS
SSSSSSSSSS
SSSSSSSSSS
SSSSSSSSSS

SSSSSSSSSS
SSSSSSSSSE
SSSSSSEIII
SSSSSSSIDS
SSSSSSEIIE
SSSSSSSESS
SSSSSSSSSS
SSSSSSSSSS
SSSSSSSSSS
SSSSSSSSSS

SSSSSSSSSS
SSSSSSSESE
ESSSSSEIII
SSSSSSSIDS
SSSSSSEIII
SSSSSSSESS
SSSSSSSSSS
SSSSSSSSSS
SSSSSSSSSS
SSSSSSSSSS

SSSSSSSSSS
SSSSSSSESE
ESSSSSEIII
SSSSSSEIDS
SSSSSSEIII
SSSSSSSISS
SSSSSSSSSS
SSSSSSSSSS
SSSSSSSSSS
SSSSSSSSSS

SSSSSSSSSS
SSSSSSSEEI
ESSSSSIIII
SSSSSSEIDS
SSSSSSIIII
SSSSSSSIES
SSSSSSSSSS
SSSSSSSSSS
SSSSSSSSSS
SSSSSSSSSS

SSSSSSSSSS
SSSSSSSIEI
ISSSSSIIII
SSSSSSEIDS
SSSSSSIIII
SSSSSESIES
SSSSSSSSSS
SSSSSSSSSS
SSSSSSSSSS
SSSSSSSSSS

SSSSSSSSSS
SSSSSSSIEI
ISSSSSIIII
SSSSSSIIDS
SSSSSEIIDI
ESSSSESIES
SSSSSSSSSS
SSSSSSSSSS
SSSSSSSSSS
SSSSSSSSSS

ESSSSSESSE
SSSSSSEIII
ISSSSEIIII
SESSSSIIDE
SSSSSEIIDI
ESSSSESIIS
SSSSSSSSSS
SSSSSSSSSS
SSSSSSSSSS
SSSSSSSSSS

ESSSSSESSE
SSSSSSEIII
ISSSSEIIII
SESSSSIIDE
SSSSSEIIDI
ESSSSISIIS
SSSSSSSSSS
SSSSSSSSSS
SSSSSSSSSS
SSSSSSSSSS

ESSSSSESSE
SSSSSSEIII
ISSSSEIIII
SESSSSIIDE
ESSSSIIIDI
ISSSSISIIS
SSSSEEESES
SSSSSSSSSS
SSSSSSSSSS
SSSSSSSSSS

ISSSSSISSI
SSSSSSIIII
ISSSSIIIII
SISSSEIIDI
ESSSSIIIDI
ISSSSISIIS
SSSSEEESES
SSSSSSSSSS
SSSSSSSSSS
SSSSSSSSSS

ISSSSSISSI
SSSSSSIIII
IESSSIIIIR
SISSSEIIDI
ESSSSIIIDD
ISSSSISIIS
ESSSEEESES
SSSSSSSSSS
SSSSSSSSSS
SESSSSSSSS

DSSSSSISSI
SESSESIIID
IESSSIIIIR
SISSEEIRDI
ISSSEIIIDD
ISSSSISIIS
ESSSIIISIS
SSSSSSSSSS
SSSSSSSSSS
SESSSSSSSE

DSSSSSISSI
SESSESIIID
IEESSIIIIR
SISSEIIRSI
ISSSEIIRDD
ISSSSISIIS
EESEIIISIS
SSSSSEESSS
SSSSSSSSSS
SESSSSSESE

DSSSSEISSI
SESSESIIID
IIESSIIRRR
SIESEIIRSI
ISSSEIIRDD
ISSSSISIIS
IESEIIISIS
SSSSSEESSS
SSSSSSSSSS
SISSSSEESE

DSSSSEISSI
SISSISIIID
IIESSIIRRR
SIESIIDRSI
ISSSIIIRDD
ISSSSISIIE
IESEIIISIS
ESSSSEESSS
SSSSSSSSSS
SIESSEEESI

DSSSSEISSI
SISSISIIID
IIISSIIRRR
SIESIIDRSI
ISEEIIIRDD
ISSSSISIIE
IISIIIISIS
ESSSSIISSS
SESSSSSSSS
SIESSEEISI

DSSSSIISSI
SISSISIIID
IIISSIIRRR
SIISIIDRSI
IEEEIIIRDD
ISSSSISIIE
IISIIIIEIS
EESSSIISSS
SESSSSSSSS
SIESSEIISI

DSEESIISSI
SISSISIIID
IIISSIIRRR
SIIEIIDRSI
IEEEIIIRDD
ISSSSISRII
IISIIIIEIS
IESSEIISSS
EESSSSSSSS
SIISSIIISI

DSEESIISSI
EISSISIIID
IIISSIRRRR
EIIEIIDREI
IEIIIIRRDD
ISSSSISRII
IISIIIIEIS
IESSEIISSS
EISSSSSSSS
SIISSIIIEI

DSEESIISSI
EISSIEIRID
RIISEIRRRR
EIIEIIDREI
IIIIIIRRSD
ISSSSISRII
IIEIIIIIIS
IISSEIISSS
EISSSSSESS
SIISEIIIEI

DSIISIISSI
EISSIEIRID
RIISEIRRRR
EIIIIIDREI
IIIIIIRRSD
IESSSISRII
IIEIIIIIIS
IISSIIISSS
IISSSSSESS
SIISEIIIEI

DSIISIISSI
IIESIEIRRD
RIIEEIRRRR
IIIIIIDRII
IIIIIIRRSD
IESSSISRRI
IIEIIIIIIS
IISSIIISSS
IISSESEESS
SIISEIIIII

